
R  600 1200
S    src/texture/sprite_1.xpm
NO   src/texture/txt64-2.xpm
SO      src/texture/wall_3.xpm  
WE     src/texture/wall2.xpm
EA  src/texture/wall1.xpm
C  225,0,130           
F   5,35,111          

  


11111111111111111111111111111111111111111111111111111111111111111111111111111111111111111111111
   10000000011001100000110110010100001001000101 1010100101001100000000000021
    1000000110011000001100101010111001001010101 101100011000011000000000001   
     100001111110011111000100110100001001101101 10101001010000111110000021     
      1000000110011000000010001011100100010100010010010100100000001010001  
       100001100011000000000000000000000000W0000000000000000000001001001    
        100110000111111111111111111111111110111111111111111111110001001    
         1000000000000000000000000000000000000000000000000000000000001     
          11111111111111111111111111111111111111111111111111111111111
 
 11111111111111111111111111111111111111111111111111111111111111111111111111111111111111111111111
   10000000011001100000110110010100001001000101 1010100101001100000000000021
    1000000110011000001100101010111001001010101 101100011000011000000000001   
     100001111110011111000100110100001001101101 10101001010000111110000021     
      1000000110011000000010001011100100010100010010010100100000001010001  
       10000110001100000000000000000000000000000000000000000000001001001    
        100110000111111111111111111111111110111111111111111111110001001    
         1000000000000000000000000000000000000000000000000000000000001     
          11111111111111111111111111111111111111111111111111111111111
 
 1111111111111111111111111111111111111111111111 111111111111111111111111111111111111111111111111
   10000000011001100000110110010100001001000101 1010100101001100000000000021
    1000000110011000001100101010111001001010101 101100011000011000000000001   
     100001111110011111000100110100001001101101 10101001010000111110000021     
      1000000110011000000010001011100100010100010010010100100000001010001  
       10000110001100000000000000000000000000000000000000000000001001001    
        100110000111111111111111111111111110111111111111111111110001001    
         1000000000000000000000000000000000000000000000000000000000001     
          11111111111111111111111111111111111111111111111111111111111